win=can
XX=be
gkuop=fatal
pwv=are
oo=to
leef=feel
swq=pain
vu=is
mjrv=true
pilk=that
xprk=like
xxd=any
ppler=other
iua=use
aa=of
eee=may
baseball=football
month=weekend
best=into
pruthu=damage
ddssddssa=ddssddssa
ccccccX=aspirin
HJJjbzs=effects
world=space
ujhmnkbhgnt=respiratory
prlfhtg=central
edfjux=system
oookj=brain
wwwft=death
bbbhnjk=careful
qaqa=most
jkjkhkfkm=advisable
op=so
iht=not
certgb=deadly
pijnvr=poison
Phjbkce=Aspirin
